{
	"numX": 13,
	"numY": 9,
	"size": [64, 64],
	"start": [32, 32],
	"tileNames": ["", "Tile01", "Tile02", "ProtoCoin", "ProtoBox"],
	"tiles": [0, 2, 0, 0, 0, 0, 0, 0, 0, 0, 0, 0, 0,
			  1, 1, 0, 1, 1, 0, 0, 0, 0, 0, 0, 1, 1,
			  1, 1, 0, 1, 1, 0, 1, 1, 1, 0, 0, 1, 1,
			  1, 1, 0, 1, 1, 0, 0, 0, 0, 0, 0, 1, 1,
			  1, 1, 0, 1, 1, 0, 0, 0, 0, 0, 0, 1, 1,
			  1, 1, 0, 2, 3, 0, 0, 0, 4, 4, 0, 1, 1,
			  1, 1, 0, 1, 0, 0, 0, 1, 1, 2, 0, 1, 1,
			  1, 2, 0, 1, 2, 0, 0, 0, 0, 0, 0, 1, 1,
			  1, 1, 1, 1, 1, 1, 1, 1, 1, 1, 1, 1, 1]
}